{
  "tile_size": 75,
  "layout": [
    "                                            ",
    "                                            ",
    "                                            ",
    "                                            ",
    "           S  S                             ",
    "          PPPPP                             ",
    "       PSS                   S           SSS",
    "============================================"
  ]
}
